11111111111111
1P000C1000C001
10000110001001
10000100011001
10001101000001
1000001110C0E1
11111111111111
