11111111111111
1P00001000C001
1000011000100x
10000100011001
10001101000001
100000011000E1
11111111111111
