11111111111111
1P00001000C001
10000110001001
10000100011001
10001101000001
100000011000E1
11111111111111
