11111111111111
1P00001000C001
100C0110001001
10000100011001
100011010C0001
10C000011000E1
11111111111111
