1111111111111111111
1P0000000000C0000C1
100C011000001000001
1000010000011001001
10001100100C0001001
10C00000110000000E1
1111111111111111111
